*****************************************************************
*000000000000000000000000000000000000000000000000000000000000000*
* 000000000000<0000000000000000000000000000000000000000000000000*
*000000000000000000000000000000080000000000000000000000000000000*
*000000000000000000000000000000000000000000000000000000000000000*
*000000000000000000000000000000000000000000000000000000000000000*
*000000000000000000000000000000000000000000000000000000000000000*
**********************000000000000000000000000000000000000000000*
*00000000000000000000*000000000000000000000000000000000000000000*
*00000000000000000000*000000000000000000000200000000000000000000*
*00000000000000000000*000000000000000000000000000000000000000000*
*00000000500000000000*000000000000000000000000000000000000000000*
*00000000000000000000*000000000000000000000000000000000000000000*
*000000000000000000000000000000000000000000000000000000000000000*
*000000000000000000000000000000000000000000000000000000000000000*
*****************************************************************